{
  "map": [
    [1, 1, 1, 1, 1, 1, 1, 1, 3, 1],
    [1, 0, 0, 0, 1, 0, 0, 1, 0, 1],
    [1, 1, 1, 0, 1, 0, 1, 1, 10, 1],
    [1, 0, 1, 0, 1, 0, 1, 0, 0, 1],
    [1, 0, 1, 0, 0, 0, 1, 0, 1, 1],
    [1, 0, 0, 0, 1, 1, 1, 0, 0, 1],
    [1, 1, 1, 0, 1, 0, 0, 0, 0, 1],
    [1, 0, 1, 0, 1, 1, 0, 0, 0, 1],
    [4, 0, 0, 0, 0, 0, 0, 0, 0, 1],
    [1, 1, 1, 1, 1, 1, 1, 1, 1, 1]
  ],
  "inMap": {
    "3": { "num": 3, "type": "finish" },
    "4": {
      "num": 4,
      "type": "warp",
      "color": "blue",
      "to": "start",
      "correlation": 3
    },
    "10": { "num": 10, "type": "door", "color": "black" }
  },
  "solution": "rrrrrruuuuuruuu"
}
